111111111111111111111111111111111
1C1111100011111010001011111010101
100000101010000000101010001010101
111110101010111111101011101010101
101000101010101000001000001000101
101011101010101011101111101111101
101010001000101010000000101000001
101011101111101011111111101010101
101000000000001000000000001010101
101111111110111111111110111010101
101000000010100000000010000010101
101011111010101111111010111110101
101010001010101000000010100010101
101010101010101011111111101010101
100010101000101010000000001010101
101110101111101011111110111010111
101000010010001000000010001010001
101111111010011011111011101010101
100000001010000010001000001010101
101111111110011110101111111011101
101000000010000000101000000000001
101011111011111111101111111111101
101010000000000000001P00000000001
101011111111111111101011111111101
101000000000000010101010000010001
101011111111111010101110111010111
1010001000000010100000001000101E1
101011101111101011111111101110101
101000000000101000000000100000101
101111111111101111111110101111101
100000000000000000000010000000001
111111111111111111111111111111111
