111111111111111111111111
1C11001010C111000111P011
10C0001110100C0111000011
111000C000C0000000011111
111111111111011111111111
111110000011000000000001
111110111011111111110101
111110111000000000110001
111100001111111110111011
111101100111000000100Y11
111001E00000001000001111
111111111111111111111111